101110011
100100100
010010001
000101011
101000101
110101000
100010010
001001001
100111010
